23
14
#######################
#.....................#
#...fHOff....HO.f...fO#
#...=H===....H===...==#
#....H....=.OH........#
#OEH.H..H...===.......#
#==H=H=.H.............#
#O.HEH..H..f.H.Ef....O#
#======...O==H===.L..=#
#OE.H.O.H..H.H.He.....#
#===H==.H.=H==OH=.....#
#O..HfffHP.H..fHf...f.#
#==.=========.===.L.==#
#######################