22
13
######################
#....................#
#....H.EO.H..fe.O.HOf#
#....H====H=.=====H==#
#f.H.H.HO.Hf..H...H..#
#==H===H==H=.=H======#
#O.H...HO.H.e.H...HEO#
#==H=.=H========.=H==#
#O.H.O.H..H...O..fH..#
#==H====.=H=.===.=H==#
#fEHf.O.P.H..O..f.H..#
#====.===============#
######################