24
15
########################
#......................#
#..............H.......#
#...HO...fHEHe.H==...fO#
#...H=...=H=H=fH..==.==#
#...H.....H.H.==.f..O.H#
#fOEH.....H.H....=..==H#
#===H..L..H.H..f.O....H#
#.HfHO....H.H.==.=...OH#
#=H===....H.H...O....==#
#.H......fHOH...=.OE.H.#
#.H..O...====.=...===H.#
#eHf==....P....f..O..H.#
#===...L.====.=========#
########################