23
14
#######################
#.....................#
#........HEf...fH.OE.H#
#...==..=H==...=H=O==H#
#O.=.....H......H....H#
#=...f...HO....=H.=O=H#
#O...=..=H==...OH.....#
#==.=....H...L.====..O#
#.......=H..........==#
#f..H...OH.e.....HO...#
#===H...=H==...==H==.=#
#O..HE..PH.f...O.H.Ef.#
#=====.=====.L.=======#
#######################