22
14
######################
#....................#
#......OHEf...Of....O#
#.....==H==.======.==#
#.......H.Of....f....#
#....OE.H.==...==....#
#...====H...O==.f.O..#
#..OHef.H..==...====.#
#..=H===H==..........#
#.O.H.feH...H.Of.H.O.#
#.======H===H====H==.#
#..f.O..H.P.Hef..H...#
#====================#
######################