22
14
######################
#...O.............O..#
#..........HE........#
#...=.O=O==H==O=O.=..#
#..........H.........#
#...eH.....H.....He..#
#...=H==.O===O.==H=..#
#....H.....HE....H...#
#..====O.==H==.O====.#
#...H......H.....EH..#
#..=H=O.=======.O=H=.#
#.ffHfffPfffffffffHff#
#====================#
######################