21
14
#####################
#.....HOHOHO........#
#.....H.H.H..fHEO...#
#.....H.H.H.==H===..#
#.HEf...O.....H.H...#
#=H===.==....===HO..#
#.He............H...#
#=H=..=..=..O..EHO.L#
#.HfH.=.Of.==..===..#
#eH=H.====..........#
#=HOH........O......#
#.H.H....P=..=......#
#...======......==OL#
#####################