24
14
########################
#......................#
#......O.......O.H..H.O#
#...O..=..=....==H==H==#
#................H..HEO#
#fEffH...O.........=H==#
#====H=................#
#....H...f.....O.H.OH..#
#..==H====..L..==H==Hef#
#H...HO........OEH..H==#
#H=.=H=........===..H..#
#HEO.H...P....ffff.OH..#
#===...====.L.====.....#
########################